2 8
6 2
0 2
  6  5  7  5  8  5  1  3
  9  5 10  8  6  1  5  5
  8  2 10  8  9  3 12  6
 10  5  8  8 10  4 14  7
 12  9  8  2  9  8 17 10
 16 11  7  5  6  8 23 10
 19  3 10 15  4 19 56  2
 53 19  5 13 16 13  5  6
