3 10
4 2
2 7
3 8
  3 28 16  6  4  3  2  3  2  5
 28 60 28 14  6  5  6  7  7  5
 29 62  4 10  1  5  5  5  9  6
 25 61  1  8 10  6  2  4  7  5
  2 55 25 12 15  4 13  7  7  4
  1 60 26  1 24 18 42 16  5  5
 24 31  5 22 41 25 19  3  4  4
  3 26  5 42 32 21  2  5  5  6
  2 19 40 31 22 13  2  3  5  4
  3  9 15 16  1  4  3  4  3  6
