5 10
2 6
1 9
9 9
6 0
1 8
  2  2  8 17 30 12  9  5  5  4
  4  4 14 26 21  3 22 60  4  4
  4  4 17 29 18  3 26 57  4  5
  1  5 11 27 15  1 28 58  3  6
  3  6 11 27 15  4 26 63  2  6
  5 13 28 20  2 17 27 64  2  4
  1 13 30 20  2 12  1 61  1  6
  5 14 26 19  2 17 21 68  2  4
  1 12 26 14  4 20 28 64  1  6
  1  8 11 10  3 19 29 68  5  3
